"Carl and the Passions changed band name to what",	"Beach Boys",	"Beatles"
"How many rings on the Olympic flag",	"5",	"7"
"Who has won the most Oscars",	"Walt Disney"	"Jack Nicholson"
"If you had pogonophobia what would you be afraid of"	"Beards"	"Spiders"
"What in business terms is the IMF"	"International Monetary Fund"	"Imperial Metric Foundation"
"Ringo Star narrates which children's TV series"	"Thomas the tank engine"	"Sesame Street"
"Which country grows the most fruit"	"China"  "The United States"
"In Casablanca what is the name of the nightclub" "Ricks"	"Casa Blanca"
"How did Alfred Nobel make his money" "He invented Dynamite"	"He invented penicillin"
"What does an alopecia sufferer lack"	"Hair"	"Vitamin C"
"Triskadeccaphobia is the fear of what"	"Number 13"	"Snakes"
"Ictheologists study what"	"Fish"	"Insects"
"What type of acid is used in car batteries"	"Sulphuric"	"Hydrochloric"
"What is the national flower of Japan"	"Chrysanthemum"	"Japanese Tulip"
"What was the world’s first high level programming language" 	IBM FORTRAN	Basic
"Consumption was the former name of which disease"	"Tuberculosis"	"Pneumonia"
"Which American state is nicknamed The Diamond State"	Delaware	Rhode Island
"Who wrote about Willie Wonka and the Chocolate Factory"	"Roald Dahl"	"Richard Stills"
"Who, at USA customs declared, nothing but my genius"	"Oscar Wilde"	"Andy Warhol"
"Who discovered blood circulation" 	"William Harvey"	"Richard Anderson"
"Who wrote Brave New World"	"Aldus Huxley"	"Kurt Vonnegut"
"What martial arts name means gentle way"	"Judo"	"Kung Fu"
"Duvali, Dushira and Holi are religious days in which religion"	"Hindu"	"Buddhism"
"In what industry did John Davidson Rockefeller get rich"	"Oil"	"Steel"
"The Mau Mau were terrorists in which country late 50s early 60s"	"Kenya"	"Brazil"
"If you suffer from epistaxis what is wrong"	"Nosebleed"	"Ear aches"
"What animals name translates as water horse"	"Hippopotamus"	"Camel"
"Which two metals are alloyed to make pewter"	"Tin and Lead"	"Tin and Copper"
"What does a polyandric women have more than one of"	"Husbands"	"Ribs"
"Barry Allen was the alter ego of which DC comic superhero"	"The Flash"	"The Green Lantern"
"In Norse mythology what is the name of the ultimate battle"	"Ragnarok"	"Razternon"
"What is the capitol of Morocco"	"Rabat"	"Borran"
"Linus Torwalds invented and wrote what"	"Linux computer operating system"	"The C programming language"
"Zambia and Zimbabwe used to be called what"	"Rhodesia"	"Zambabwe"
"What is the staple food of one third of the world’s population"	"Rice"	"Potatoes"
"Ageusia is the loss of which sense"	Taste	Smell
"Crazy Horse and Sitting Bull were born in which US state"	"South Dakota"	"North Dakota"
"In 1901 who first transmitted radio signals across Atlantic"	"Marconi"	"Alexander Graham Bell"
"What is the state capitol of New Jersey"	"Trenton"	"Jersey City"
"Who sold Louisiana to the USA in 1803"	"Napoleon"	"The King of Spain"
"What's missing from ale that’s included in beer"	"Hops"	"Wheat"
"Who is the only American president elected unopposed"	"George Washington"	"Thomas Jefferson"
"What was the first credit card"	"Diners Club"	"ChargEx"
"What did Britain swap Havana for with Spain in 1763"	"Florida"	"The Philippines"
"What was Norman Bates hobby in Psycho"	"Stuffing birds"	"Rock Collecting"
"In Kansas what can a waiter not do in a teacup (legally)"	"Serve wine"	"Serve water"
"Which country has the smallest birth rate"	"Vatican City"	"Haiti"
